11111111111111111111
100003e300003e300001
10000333000033300001
10000000000000000001
10054435000054354001
10000000022000000001
10000000288200000001
10000002888820000001
13000028887882000061
15460288877888266621
14600028888782000661
10000002878820000001
10000000288200000001
10000000022000000001
10000000000000000001
10000111000001110001
10001000100010001001
10000000033300000001
1000000003p300000001
11111111111111111111