11111111111111111111
10003e30000003e30001
10003330000003330001
10000000000000000001
10043200005500020001
10000000000000000001
10000000000000000001
10000000000000000001
10000000000000000001
10000000000000000001
10000000000000000001
10000000000000000001
10000000000000000001
10000000000000000001
10000000000000000001
10000000000000000001
10000000000000000001
10000000333000000001
100000003p3000000001
11111111111111111111